{
  "tileSize": 16,
  "width": 20,
  "height": 15,
  "legend": {
    "0": "grass",
    "1": "path",
    "2": "water",
    "3": "wall"
  },
  "solids": [3,2],
  "tiles": [
    3,3,3,3,3,3,3,3,3,3,3,3,3,3,3,3,3,3,3,3,
    3,0,0,0,0,0,0,0,0,1,1,0,0,0,0,0,0,0,0,3,
    3,0,0,0,0,0,0,0,0,1,1,0,0,2,2,2,0,0,0,3,
    3,0,0,0,0,0,0,0,0,1,1,0,0,2,0,2,0,0,0,3,
    3,0,0,0,0,0,0,0,0,1,1,0,0,2,0,2,0,0,0,3,
    3,0,0,0,1,1,1,1,1,1,1,1,1,2,0,2,1,1,0,3,
    3,0,0,0,1,0,0,0,0,0,0,0,1,2,0,2,0,1,0,3,
    3,0,0,0,1,0,0,0,0,0,0,0,1,2,0,2,0,1,0,3,
    3,0,0,0,1,0,0,0,0,0,0,0,1,2,0,2,0,1,0,3,
    3,0,0,0,1,1,1,1,1,0,0,1,1,2,0,2,1,1,0,3,
    3,0,0,0,0,0,0,0,1,1,1,1,0,2,0,2,0,0,0,3,
    3,0,0,0,0,0,0,0,0,1,1,0,0,2,2,2,0,0,0,3,
    3,0,0,0,0,0,0,0,0,1,1,0,0,0,0,0,0,0,0,3,
    3,0,0,0,0,0,0,0,0,1,1,0,0,0,0,0,0,0,0,3,
    3,3,3,3,3,3,3,3,3,3,3,3,3,3,3,3,3,3,3,3
  ],
  "spawn": { "x": 3, "y": 3 },
  "npcs": [
    {
      "x": 10,
      "y": 6,
      "mbti": "ENFP",
      "gender": "female",
      "skin": "#e0ac69",
      "text": "สวัสดี ยินดีต้อนรับสู่หมู่บ้าน!"
    }
  ]
}